GPFM
20,20
####################
#...#..............#
#.....###.###......#
#######.....#......#
#...........#......#
#############......#
#...........#......#
#....#......#......#
#....#......#......#
#....########......#
#..................#
#..................#
#..................#
#..................#
#..................#
#..................#
#..................#
#..................#
#..................#
####################