GPFM
10,10
.#........
.#....@...
.#........
.#.####...
.#.#......
.#.#......
.#.#......
.#.#......
.#.#......
...#......